# Resources from graph.properties
alreadyConnected=Nós já conectados
cancel=Cancelar
close=Fechar
collapse-expand=Reduzir/Expandir
containsValidationErrors=Contém erros de validação
done=Feito
doubleClickOrientation=Clique duplo para mudar modificação
error=Erros
ok=OK
updatingDocument=Atualizando documento. Por favor aguarde...
updatingSelection=Atualização da seleção. Por favor aguarde...
# Custom resources
about=Sobre
actualSize=Tamanho atual
add=Adicionar
addLayer=Adicionar camada 
addProperty=Adicionar propriedades
addToExistingDrawing=Adicionar ao modelo existente
addWaypoint=Adicionar ponto de rota
advanced=Avançado
align=Alinhar
alignment=Alimnhamento
allChangesLost=Todas as alterações serão perdidas!
angle=Ângulo
apply=Aplicar
arrange=Organizar
arrow=Flecha
arrows=Flechas
automatic=Automático
autosave=Auto savar
autosize=Tamanho automático
background=Plano de fundo
backgroundColor=Cor de fundo
backgroundImage=Imagem de fundo
basic=Básico
block=Bloquear
blockquote=Citação
bold=Negrito
borderWidth=Largura da borda
borderColor=Cor da borda
bottom=fundo
bottomAlign=Alinhar ao fundo
bottomLeft=Inferior esquerdo
bottomRight=Inferior direito
bulletedList=Lista com marcadores
cannotOpenFile=Não é possível abrir arquivo
center=Centro
change=Modificar
changeOrientation=Modificar orientação
circle=Circulos
classic=Classicos
clearDefaultStyle=Limpar padrão estilo
clearWaypoints=Limpar pontos de notificação
clipart=Clipart
collapse=Recolher
collapseExpand=Recolher/Expandir
collapsible=flexivel
comic=Comic
connect=Connectar
connection=Conexão
connectionPoints=Ponto de conexão
connectionArrows=Setas de conexão
constrainProportions=estringir proporções
copy=Copiar
copyConnect=copiar ao conector
create=Criar
curved=curvado
custom=Personalizado
cut=Cortar
dashed=Tracejado 
decreaseIndent=Diminuir ajuste
default=Padrão
delete=Excluir
deleteColumn=Excluir coluna
deleteRow=Deletar linha
diagram=Modelo
diamond=diamante
diamondThin=Diamante (fino)
direction=Direção
distribute=Distribuir
divider=Dividir
documentProperties=Propriedades do documento
dotted=Pontilhado
drawing=Modelo{1}
drawingEmpty=O modelo está vazio
drawingTooLarge=Modelo muito grande
duplicate=Duplicar
duplicateIt=Duplicar {1}
east=Leste
edit=Editar
editData=Editar Dados
editDiagram=Edit Modelo
editImage=Editar Imagem
editLink=Editar Link
editStyle=Editar estilo
editTooltip=Editar barra de ferramentas
enterGroup=Inserir grupo
enterValue=Inserir valor
enterName=Inserir nome
enterPropertyName=Entrar com o nome de propriedade
entityRelation=Relação de entidade
exitGroup=Sair do grupo
expand=Expandir
export=Exportar
extras=Extras
file=Arquivo
fileNotFound=Arquivo não encontrado
filename=Nome do aruqivo
fill=Preenchimento
fillColor=Cor de preenchimento
fitPage=Uma página
fitPageWidth=Ajustar largura da página
fitTwoPages=Duas páginas
fitWindow=Ajustar janela
flip=Virar
flipH=virar Horizontal
flipV=virar Vertical
font=Fonte
fontFamily=Tipo da fonte
fontColor=Car da fonte
fontSize=Tamanho da fonte
format=Formato
formatPanel=Formatar painel
formatPdf=PDF
formatPng=PNG
formatGif=GIF
formatJpg=JPEG
formatSvg=SVG
formatXml=XML
formatted=Formatado
formattedText=Texto formatado
general=Geral
glass=vidro
global=Global
gradient=Gradiente
gradientColor=Cor
grid=Malha
gridSize=Tamanho da malha
group=Grupo
guides=Guias
heading=Cabeçalho
height=Altura
help=ajuda
hide=Oculto
hideIt=Ocultar {1}
hidden=Oculto
home=Inicio
horizontal=Horizontal
horizontalFlow=Fluxo Horizontal
horizontalTree=Árvore Horizontal
html=HTML
image=Imagem
images=Imagens
import=Importar
increaseIndent=Aumentar ajuste
insert=Inserir
insertColumnBefore=Inserir coluna à esquerda
insertColumnAfter=Inserir coluna à direita
insertHorizontalRule=Inserir linha horizontal
insertImage=Inserir Imagem
insertLink=Inserir Link
insertRowBefore=Inserir linha acima
insertRowAfter=Inserir linha abaixo
invalidName=Nome inválido
invalidOrMissingFile=Arquivo inválido ou em falta
isometric=Isometrico
italic=Itálico 
layers=Camadas
landscape=Paisagem 
laneColor=Palheta de cores
layout=Traçado
left=Esquerda
leftAlign=Alinhar à esquerda
leftToRight=Esquerda para direita
line=linha
link=Link
lineend=Fim da linha
lineheight=Comprimento da linha
linestart=Inicio da linha
linewidth=Largura da linha
loading=Carregando...
lockUnlock=Travar/Destravar
manual=Manual
middle=Meio
misc=Misc
more=Mais
moreResults=Mais resultados
move=Mover
moveSelectionTo=Mover seleção para {1}
navigation=Navegãção
new=Novo
noColor=Sem cor
noFiles=Sem arquivos
noMoreResults=Sem mais resultados
none=Nada
noResultsFor=Sem resultados para '{1}'
normal=Normal
north=Norte
numberedList=Lista numerada
opacity=Opacidade
open=Abrir
openArrow=Abrir seta
openFile=Abrir aquivo
openLink=Abrir Link
openSupported=Os formatos suportados são arquivos salvos deste software (.xml)
openInNewWindow=Abrir numa nova janela
openInThisWindow=Abrir nessa janela
options=opções
organic=Orgânico
orthogonal=Ortogonal
outline=Contorno
oval=Oval
pages=Página
pageView=Layout da Página 
pageScale=Escala da Página
pageSetup=Configuração da Página
panTooltip=Espaço+Arrastar para deslocar
paperSize=Tamanho do Papel
paste=colar
pasteHere=Cole aqui
pattern=Padronizar
perimeter=Perimetro
placeholders=Espaços reservados
plusTooltip=Clique e arraste para contectar; clique para clonar e conectar; shift-clique para clonar
portrait=Retrato
position=Posição
posterPrint=Impressão do modelo
preview=Visualização
print=Impressão
radialTree=Árvore Radial
redo=Refazer
removeFormat=Limpar formatação
removeFromGroup=Remover do grupo
removeIt=Remover {1}
removeWaypoint=Remover ponto de notificação
rename=Renomear
renameIt=Renomear {1}
replace=Substituir
replaceIt={1} já existe. Você deseja substituí-lo?
replaceExistingDrawing=Substituir modelo já existente
reset=Redefinir
resetView=Redefinir vista
reverse=Reverso
right=Direita
rightAlign=Alinhar à direita 
rightToLeft=Direita para esquerda
rotate=Rodar
rotateTooltip=Clique e arraste para rodar, clique para girar 90 graus
rotation=Rotação
rounded=Arredondado 
save=Savar
saveAs=Salvar como
saved=Salvo
scrollbars=Barras de rolagem
search=Pesquisar
searchShapes=Procurar Formas
selectAll=Selecionar tudo
selectEdges=Selecione arestas
selectFont=Selecione uma fonte
selectNone=Selecione nenhum
selectVertices=Selecione vértices
setAsDefaultStyle=Configurar como estilo padrão
shadow=Sombra
shape=Forma
sharp=Afiar
sidebarTooltip=Clique para expandir. Arraste e solte formas no diagrama. Shift+clique para alterar a seleção. Alt+clique para inserir e conectar.
simple=Simples
simpleArrow=Seta Simples
size=Tamanho
solid=Sólido
sourceSpacing=Espaçamento entre fontes
south=Sul
spacing=Começando
straight=Reto
strokeColor=Cor da linha
style=Stilo
subscript=Subscrito
superscript=Sobrescrito
table=Tabela
targetSpacing=Espaçamento do alvo 
text=Texto
textAlignment=Alinhamento de Texto
textOpacity=Opacidade de texto
toBack=Para trás
toFront=Para frente
tooltips=Barras de ferramentas
top=Topo
topAlign=Alinhar ao topo
topLeft=Canto superior esquerdo
topRight=Canto superior direito
transparent=Transparente
turn=Girar
uml=UML
underline=Sublinhado 
undo=Desfazer
ungroup=Desagrupar
url=URL
untitledLayer=amada sem título
vertical=Vertical
verticalFlow=Fluxo Vertical
verticalTree=Arvore Vertical
view=Visualização
waypoints=Pontos de notificação
west=Oeste
width=Largura
wordWrap=Quebra de linha
writingDirection=Direção de escrita
zoom=Zoom
zoomIn=Mais Zoom
zoomOut=Menos Zoom
